e:80
__________________________________________________________________________________________
__________________________________________________________________________________________
__________________________________________________________________________________________
__________________________________________________________________________________________
__________________________________________________________________________________________
__________________________________________________________________________________________
__________________________________________________________________________________________
__________________________________________________________________________________________
__________________________________________________________________________________________
__________________________________________________________________________________________
__________________________________________________________________________________________
__________________________________________________________________________________________
__________________________________________________________________________________________
__________________________________________________________________________________________
__________________________________________________________________________________________
__________________________________________________________________________________________
__________________________________________________________________________________________
__________________________________________________________________________________________
__________________________________________________________________________________________
__________________________________________________________________________________________
__________________________________________________________________________________________
__________________________________________________________________________________________
__________________________________________________________________________________________
_____________...._________________________________________________________________________
_____________.__Q_________________________________________________________________________
_____________.G_Q_________________________________________________________________________
_____________.............,,,...__________________________________________________________
_______________...........,,,...._________________________________________________________
_______________.1__o{{{{{{,,,.....____________+___________________________________________
_______________..,,................,,,,,,....|||..._______________________________________
__________________________________.,{,,{,.________________________________________________
___________________________________,,,,,,_________________________________________________
__________________________________________________________________________________________
__________________________________________________________________________________________
__________________________________________+_______________________________________________
_________________..|____________aaa......|||_www__________________________________________
__________________________________________________________________________________________
__________________________________________________________________________________________
__________________________________________________________________________________________
__________________________________________________________________________________________
__________________________________________________________________________________________
____...___...___|____________________aaa_www______________________________________________
__________________________________________________________________________________________
~~~~~~~~~~~~~~~~~~~~~~~~~~~~~~~~~~~~~~~~~~~~~~~~~~~~~~~~~~~~~~~~~~~~~~~~~~~~~~~~~~~~~~~~~~
..........................................................................................