_______________
_______________
__*___________.
_...____....___
.___...________
.___...________
.___...________
.___...________