_______________
__*_____++++___
________++++__.
_...____....___
.___.__._______
.___.__._______
.___.__._______
.___...._______