_______________
__*____________
_________++___.
_...____....___
.___.__._______
.___.__._______
.___.__._______
.___...._______