e:200
_______________
__o_____{{++__~
________{{++__.
_...____....___
.___.__._______
.___.__._______
.___.__._______
.___...._______