_______________
__*____________
______________.
_...____....___
.___...________
.___...________
.___...________
.___...________