_______________
__*____________
______________.
_...____....___
.___.__._______
.___.__._______
.___.__._______
.___...._______