e:200
_______________
__*_____%%++__~
________%%++__.
_...____....___
.___.__._______
.___.__._______
.___.__._______
.___...._______